1111111111111111111111111
110000100011000000100C001
1111011001110000000000001
1101000000000100000001001
1111111110110000011100001
1100000000110000011101111
1111011111111101110000000
1111011111111101110101001
1100000011010101110000001
11000100000100001100000E1
1100000000000000110101001
110000P111010101111101111
1111111111111111111111111
