1111111111111111111111111
1100000000110000000000001
11110C000111P000C00000001
110100000000000000000C001
1111111110110000011100001
1100000000110000011101111
1111011111111101110000001
1111011111111101110101001
1100000011010101110000001
11000C00000C00001100000E1
1100000000000000110101001
1100000111010101111101111
1111111111111111111111111
1111111111111111111111111