1111111111111111111111111
1100000000110000000X000C1
11110C000111C000C00000001
11010000000000X000000C001
1111111110110000011100001
1100000000110000011101111
1111011111111101110000001
1111011111111101110101001
1100000011010101110000001
11000C00000C00001100000E1
11000X0000000000110101001
110000P111010101111101111
1111111111111111111111111
