1111111111111111111111111
1100001000110000000010001
11110C000111C000C00000001
110100100000000000100C001
1111111110110000011100001
1100000000110000011101111
1111011111111101110000001
1111011111111101110101001
1100000011010101110011001
11000C00000C000C1100000E1
110100100000010011C101001
110000P111010101111101111
1111111111111111111111111
1111111111111111111111111
